11111111111111111111111111111
10000000000000000000000000001
100000P00011111110000000N0001
10000000000000000000C1C000001
1000000N00000000011111100C001
100N0000000000C00000000000001
10011C11100000000000000000001
100000000000000N000CC00000101
10000000000000000000001110E01
11111111111111111111111111111