1111111111
1P00000001
10000C0001
100C0000C1
10000E0001
1111111111