11111111111111111111111111111
10000000000000000000000000001
100000P0000000000000000000001
10000000000000000000000000001
10000000000000000000000000001
10000000000000C00000000000001
10000000000000000000000000001
10000000000000000000000000001
10000000000000000000000000E01
11111111111111111111111111111