1111111
1P000C1
1000001
1C00E01
1111111