1111111111111111111
1P000000000E0000001
1000000000000E00001
EEEEEEEEEEEEEEEEEEE
1111111111000001111