111111111111111111111111
1E0000000E00000000000001
1P000000000000000C000001
100000000000000000000001
111111111111111111111111