11111111
1P000001
1E111001
11111011
1C001001
11111111