11111
10001
10C01
10P01
111111